########   ##
#        . .#
# #####  . .#
# #   #  . .#
# # # #### .#
  # # #    .#
### # # ## .#
#   #   #...#
#########.#.#
#   #   #..F#
# # # # # ###
# #   #     #
#############
