###########
# #   #   #
# # # ### #
# # # #   #
# ### # ###
# #   #   #
# # ##### #
# #     # #
# ##### # #
#         #
###########
