#############
#   # #     #
# # # ### # #
# # #   # # #
# ##### ### #
#       #   #
# ####### ###
# #     #   #
# ##### # # #
# #   #   # #
# # # ##### #
#   #       #
#############
