#############
#   #       #
### # #######
# # #       #
# # ####### #
#   #       #
# ### ##### #
# #   #     #
# ### #######
#   #       #
### ####### #
#           #
#############
