#############
#.........# #
#.#######.# #
#.#     #.# #
#.# # ###.# #
#.# #   #.  #
#.### # ### #
#...# #     #
# #.# ##### #
# #.# #   # #
# #.### # # #
# #F    # # #
#############
