#############
#           #
# ### #######
# #   #     #
# # ####### #
# # #     # #
### # ### # #
#   # # #   #
# ### # #####
#   # #     #
# # # # ### #
# #     #   #
#############
