###########
#     #   #
# ### # # #
# #   # # #
# ####### #
# #   #   #
# # # # # #
#   #   # #
######### #
#         #
###########
