#########
#       #
### #####
#   #   #
# ### # #
#   # # #
#.# ### #
#F#     #
#########
