###############
# #   #       #
# ### ####### #
#   # #       #
# ### # ##### #
#   # #   #   #
# # # ### # ###
# # #     # # #
### ####### # #
#   #     # # #
# # # ### # # #
# # # #   # # #
# ### # ### # #
#     #       #
###############
