#############
#       #   #
# ### # # # #
# #   #   # #
# # ####### #
# # #       #
# # #########
# # #       #
# # # ##### #
# # #     # #
# # ### ### #
# #     #   #
#############
