#################
#   #...........#
#.###.##### ###.#
#.#...#   # #...#
#.#.##### ###.# #
#...#   #   #.# #
# ### # ### #.###
#   # #     #...#
# ### #########.#
# #   #    .....#
# # ##### #.#####
# # #   # #.....#
### # # # #####.#
#   # # #   #  .#
# ### # ##### #.#
#     #       #F#
#################
