#############
#     #   # #
### # # # # #
#   # # #   #
# ### # ### #
#   #   #   #
### #########
#   #   #   #
# ### # # # #
# #   #   # #
# # ####### #
#   #       #
#############
