###########
#F......# #
#.#####.# #
#.....#...#
#####.###.#
# # ..# #.#
# ##.#  ..#
#         #
# ##    ###
#   #     #
###########
