#############
# #       # #
# # ### ### #
# # # #     #
# # # #######
#   #   #   #
# ### # ### #
# #   #   # #
# # # ### # #
# # # # # # #
# ### # # # #
#     #     #
#############
