###########
#   #     #
# # ##### #
# #   #   #
# ### # # #
# # # # # #
# # ### ###
#     #   #
##### ### #
#         #
###########
