#############
#           #
######### # #
#   #     # #
# # # #######
# #   #     #
# ##### ### #
#   #     # #
# # # ##### #
# #   #   # #
# ##### # # #
#     # #   #
#############
