#############
#     #     #
# ### ### # #
#   #   # # #
# # ### # ###
# # # # #   #
### # # ### #
#   # # #   #
##### # # ###
# #     #   #
# # ####### #
#           #
#############
