#############
#       #   #
# ##### ### #
# #   # #   #
# ### # # # #
#   # # # # #
# # # # # # #
# # # # # # #
### # # # ###
#   # # #   #
# ### # ### #
# #         #
#############
