#############
# #         #
# # ### ### #
#   #   #   #
##### ##### #
#   #     # #
### # ### # #
# # #   # # #
# # ##### # #
# #       # #
# ######### #
#           #
#############
