#####
# ..#
###.#
#  F#
#####
