#####
#...#
#.###
#..F#
#####
