#####
#F# #
#.  #
#...#
#####
