###############
#         #   #
# ##### # ### #
# # #   #   # #
# # # ##### # #
#   #   #   # #
####### # ### #
#       #     #
# ########### #
#   #       # #
##### ##### # #
#         # # #
# ####### ### #
#       #     #
###############
