#   #
#   #
#.# #
#F# #
#####
