#  ##
#  .#
##..#
# .F#
#####
