###########
# #.......#
# #.# ###.#
#...# #  .#
#.### #####
#.#   #   #
#.# # # # #
#.# # # # #
#F# ##### #
# #       #
###########
