###########
#       # #
# ####### #
# #       #
# ### #####
#   #     #
### # ### #
# # #   # #
# # ##### #
#         #
###########
