#########
# #     #
# ##### #
#     # #
# ### # #
# #   # #
# # ### #
# #     #
#########
