###########
#   #   ..#
# # ###  .#
# # #    .#
# # # ## .#
# # #    .#
# #####  .#
# #      .#
# #    #..#
#   #   .F#
###########
