#####
#F..#
###.#
#  .#
#####
