#############
#     #     #
### # # ### #
#   # # # # #
# ##### # # #
# #       # #
# # ####### #
# # #     # #
# # # ### # #
#   # # # # #
# ### # # # #
#   # #     #
#############

